64
#......#....................#......#....................########
###....###..................#......#....................########
#S#....###..................#......#....................########
#.#....###..................#......#....................########
.......###..................#......#....................########
..#..#####...################......#....................########
...#.#......................#......#....................########
.......#########............#......#....................########
................#...........#......#....................########
##...............#..........#......#....................########
##...............#..........#......#....................########
####.########....#..........#......#............................
####.########....#.....................#..........#.............
#############....#..........#......#............................
#..........#..........#.....#########......#......######........
#......#....................#..........#..........#.............
#########......#......#######..........#..........#.............
#########......#......#######..........#..........#.....########
#########......#......#######..........#..........#.....########
#########......#......#######..........#..........#.....########
#..........#..........#.....#..........#..........#.....########
#..........#..........#.....#..........#..........#.....########
#..........#..........#.....#..........#..........#.....########
#..........#..........#.....#..........#..........#.....########
#..........#..........#.....#..........#..........#.....########
#..........#................#..........#..........#.....########
#..........#................#..........#..........#.....########
#..........#................#..........#..........#.....########
#......#....................#......#....................########
###....###..................#......#....................########
#.#....###..................#......#....................########
#.#....###..................#......#....................########
.......###..................#......#....................########
..#..#####...################......#....................########
...#.#......................#......#....................########
.......#########............#......#....................########
................#...........#......#....................########
##...............#..........#......#....................########
##...............#..........#......#....................########
####.########....#..........#......#....................########
####.########....#..........#..........#..........#.....########
#############....#..........#......#............................
#..........#..........#.....#########......#......##############
#......#....................#..........#..........#.............
#########......#......#######..........#..........#.............
#########......#......#######..........#..........#.............
#########......#......#######..........#..........#.............
#########......#......#######..........#..........#.............
#..........#..........#.....#..........#..........#.............
#..........#..........#.....#..........#..........#.............
#..........#..........#.....#..........#..........#.............
#..........#..........#.....#..........#..........#.............
#..........#..........#.....#..........#..........#.............
#..........#................#..........#..........#.............
#..........#................#..........#..........#.............
#..........#...............##..........#..........#.............
####.########....#..........#..........#..........#.............
####.########....#..........#..........#..........#.............
####.########....#..........#..........#..........#.............
####.########....#..........#..........#..........#.............
####.########....#..........#..........#..........#.............
####.########....#..........#..........#........................
####.########....#..........#..........#..........#............G
####.########....#..........#..........#..........#.............